1, 1, 2, 3, 2, 3, 2, 3, 2, 3, 2, 3, 1, 1, 1, 1, 1, 1, 2, 3, 2, 3, 2, 3, 2, 3, 2, 3, 1, 1, 1, 1, 1, 1, 1, 1, 1, 1, 1, 1, 4, 5, 6, 7, 6, 7, 8, 9, 
10, 11, 12, 13, 12, 13, 12, 13, 12, 13, 12, 13, 14, 14, 14, 14, 10, 11, 12, 13, 12, 13, 12, 13, 12, 13, 12, 13, 14, 14, 14, 14, 14, 14, 14, 14, 14, 14, 14, 14, 15, 16, 17, 18, 17, 18, 19, 20, 
21, 22, 21, 22, 21, 22, 21, 22, 21, 22, 21, 22, 23, 24, 23, 24, 21, 22, 21, 22, 21, 22, 21, 22, 21, 22, 21, 22, 23, 24, 23, 24, 23, 24, 23, 24, 23, 24, 23, 24, 20, 20, 25, 26, 25, 26, 27, 20, 
28, 29, 30, 29, 28, 29, 28, 29, 28, 29, 28, 29, 12, 13, 12, 13, 28, 29, 30, 29, 28, 29, 28, 29, 28, 29, 28, 29, 12, 13, 12, 13, 12, 13, 12, 13, 31, 13, 31, 13, 20, 17, 32, 33, 34, 26, 35, 20, 
21, 22, 36, 37, 21, 22, 21, 22, 21, 22, 21, 22, 21, 22, 21, 22, 21, 22, 36, 37, 21, 22, 21, 22, 21, 22, 21, 22, 21, 22, 21, 22, 21, 22, 21, 22, 36, 37, 36, 37, 20, 38, 39, 20, 25, 26, 40, 20,
30, 29, 41, 20, 30, 29, 30, 29, 30, 29, 30, 29, 30, 29, 30, 29, 30, 29, 41, 20, 30, 29, 30, 29, 30, 29, 30, 29, 30, 29, 30, 29, 30, 29, 30, 29, 41, 20, 41, 20, 20, 34, 40, 20, 34, 26, 19, 20, 
36, 37, 42, 43, 36, 37, 36, 37, 36, 37, 36, 37, 36, 37, 36, 37, 36, 37, 42, 43, 36, 37, 36, 37, 36, 37, 36, 37, 36, 37, 36, 37, 36, 37, 36, 37, 42, 43, 20, 20, 20, 38, 40, 20, 25, 26, 27, 20, 
41, 44, 45, 46, 41, 20, 41, 44, 41, 44, 41, 20, 41, 44, 41, 20, 41, 44, 45, 46, 41, 20, 41, 44, 41, 44, 41, 20, 41, 44, 41, 20, 41, 20, 41, 20, 45, 46, 20, 20, 20, 34, 47, 20, 34, 48, 49, 20, 
50, 51, 52, 53, 54, 54, 50, 51, 50, 51, 54, 54, 50, 51, 54, 54, 50, 51, 52, 53, 54, 54, 50, 51, 50, 51, 54, 54, 50, 51, 54, 54, 54, 54, 55, 56, 52, 53, 57, 58, 59, 60, 61, 20, 62, 63, 27, 20, 
64, 65, 66, 67, 68, 68, 64, 65, 64, 65, 68, 68, 64, 65, 68, 68, 64, 65, 66, 67, 68, 68, 64, 65, 64, 65, 68, 68, 64, 65, 68, 68, 68, 68, 69, 70, 66, 67, 71, 69, 72, 73, 74, 75, 74, 76, 76, 75, 
77, 77, 77, 77, 77, 77, 77, 77, 77, 77, 77, 77, 77, 77, 77, 77, 77, 77, 77, 77, 77, 77, 77, 77, 77, 77, 77, 77, 77, 77, 77, 77, 77, 77, 77, 77, 77, 77, 77, 77, 77, 77, 77, 77, 77, 77, 77, 77, 
20, 20, 20, 20, 20, 20, 20, 20, 20, 20, 20, 20, 20, 20, 20, 20, 20, 20, 20, 20, 20, 20, 20, 20, 20, 20, 20, 20, 20, 20, 20, 20, 20, 20, 20, 20, 20, 20, 20, 20, 20, 20, 20, 20, 20, 20, 20, 20 