0 4352 244 32 32 2 1 -1 16 16
0 4320 212 32 32 2 1 -1 16 16
0 4384 276 32 32 2 1 -1 16 16


0 5538 245 32 32 2 1 1 16 16
0 5474 309 32 32 2 1 1 16 16
0 5506 277 32 32 2 1 1 16 16
