666 3140 140 1 stage2.1
50 3815 369 -1 3075 4090 3597 0 10 16 1

11 3765 360 32 6 1 -1 338
0 3786 399 40 5 2 3 -1 16 16 3774
0 3808 405 32 32 2 1 -1 16 16
7 3845 431 29 22 2 stage3.1 -1 -1 0.00 0.00 7

0 3706 245 5 190 0
0 3578 242 197 6 1
0 3768 245 6 23 0
0 4077 238 20 162 0
0 4034 83 5 25 0
0 3905 211 425 6 1

0 3781 275 90 6 1
11 3840 238 32 5 1 -1 211

0 3843 271 32 16 2 3 -1 16 16 3843
0 3876 290 44 38 2 1 -1 16 16
0 3903 307 32 32 2 1 -1 16 16
0 3935 339 32 32 2 1 -1 16 16
0 3967 371 32 16 2 1 -1 16 16

0 3984 395 32 5 2 0 -1 16 16 3968
11 3984 390 32 5 -1 -1 336

10 4068 110 -1 4080 5630 240 3140 120 1 stage2.3



0 0 402 5632 2 1
0 2777 210 550 2 1
0 3321 214 4 22 0

11 3135 360 32 6 1 -1 338
0 3145 399 40 5 2 3 -1 16 16 3138
0 3170 405 32 32 2 1 -1 16 16
7 3204 431 29 22 2 stage3 -1 -1 0.00 -0.00 7

0 3328 275 104 5 1
11 3390 230 32 6 1 -1 212
0 3415 268 32 16 2 3 -1 16 16 3398
0 3399 268 32 16 2 1 -1 25 25
0 3422 278 32 32 2 1 -1 15 15
0 3454 301 32 32 2 1 -1 15 15
0 3486 333 32 32 2 1 -1 15 15
0 3518 365 32 24 2 1 -1 15 15
0 3535 395 32 5 2 0 -1 16 16 3520
11 3535 390 32 5 -1 -1 336

0 3056 239 32 166 0

0 3585 245 4 90 0
1 3586 339 32 35 -1
1 3586 370 32 35 107
0 3589 331 128 10 6
0 3620 331 3 125 0

8 3500 70 -1 2 50 500 4000 1

2 3125 336 1 105 1
2 3767 336 1 101 1

2 3514 275 1 101 1

2 3256 151 1 100 1
2 4025 151 1 101 1

2 3385 120 1 101 1
2 3670 120 1 100 1
2 3890 90 1 108 1
