50 99 44 1 0 1024 0 0 10 16 -1
0 0 80 10 400 0
0 0 240 1024 10 1

0 98 80 32 32 2 1 -1 16 16
0 130 112 32 32 2 1 -1 16 16
0 162 144 32 32 2 1 -1 16 16
0 177 178 32 5 2 0 -1 16 16
11 177 176 32 5 -1 -1 116
0 195 181 62 5 1