1, 2, 3, 4, 5, 6, 7, 8, 9, 10, 11, 12, 13, 14, 15, 16, 17, 18, 19, 20, 21, 22, 23, 24, 25, 26, 27, 28, 29, 30, 31, 32, 33, 34, 35, 36, 37, 38, 39, 40, 41, 42, 43, 44, 45, 46, 47, 48, 49, 50, 51, 52, 53, 54, 55, 56, 57, 58, 59, 60, 61, 62, 63, 64, 65, 66, 67, 4, 68, 69, 70, 71, 72, 73, 74, 12, 75, 76, 77, 78, 79, 18, 80, 81, 82, 83, 84, 85, 86, 87, 88, 89, 90, 91, 92, 93, 94, 95, 96,
97, 98, 99, 100, 101, 102, 103, 104, 105, 106, 107, 108, 109, 110, 111, 112, 113, 114, 115, 116, 117, 118, 119, 120, 121, 122, 123, 124, 125, 126, 127, 128, 129, 130, 131, 132, 133, 134, 135, 136, 137, 138, 139, 140, 141, 142, 143, 144, 145, 146, 147, 148, 149, 150, 151, 152, 153, 154, 155, 156, 157, 158, 159, 160, 161, 162, 99, 100, 163, 164, 165, 166, 167, 168, 169, 108, 170, 171, 172, 173, 174, 114, 175, 176, 177, 178, 179, 180, 181, 182, 183, 184, 185, 186, 187, 188, 189, 190, 191,
192, 193, 194, 100, 195, 196, 197, 198, 199, 200, 201, 108, 202, 203, 204, 205, 206, 207, 208, 116, 209, 210, 211, 212, 213, 214, 215, 124, 125, 216, 217, 218, 219, 220, 221, 222, 133, 223, 224, 225, 226, 227, 228, 229, 230, 231, 232, 233, 234, 235, 236, 237, 238, 239, 240, 241, 242, 243, 244, 245, 246, 247, 248, 249, 250, 193, 194, 100, 251, 252, 253, 166, 254, 255, 256, 108, 257, 258, 259, 173, 260, 261, 262, 263, 264, 265, 266, 267, 268, 269, 270, 271, 272, 273, 274, 275, 276, 277, 278,
279, 280, 281, 100, 282, 283, 284, 285, 286, 106, 107, 108, 287, 288, 289, 290, 291, 114, 115, 116, 292, 293, 294, 295, 296, 122, 123, 124, 125, 297, 298, 299, 300, 301, 302, 303, 133, 304, 305, 306, 226, 307, 139, 140, 141, 308, 309, 310, 311, 312, 313, 314, 315, 316, 317, 318, 319, 320, 321, 322, 323, 324, 325, 326, 327, 280, 281, 100, 251, 252, 253, 166, 254, 255, 256, 108, 257, 258, 259, 173, 328, 329, 330, 263, 331, 178, 332, 333, 334, 335, 336, 337, 338, 339, 340, 341, 342, 343, 344,
345, 346, 347, 100, 348, 349, 350, 351, 352, 200, 201, 108, 353, 354, 355, 356, 357, 261, 358, 116, 359, 360, 361, 362, 363, 214, 215, 124, 125, 364, 365, 366, 367, 368, 369, 370, 133, 223, 224, 225, 226, 371, 372, 373, 374, 375, 376, 377, 378, 379, 380, 381, 382, 383, 384, 385, 386, 387, 388, 389, 390, 391, 392, 393, 394, 395, 396, 100, 251, 252, 253, 166, 254, 255, 256, 108, 257, 258, 259, 173, 397, 398, 399, 263, 400, 401, 402, 403, 404, 405, 406, 407, 408, 409, 410, 411, 412, 413, 414,
415, 416, 281, 100, 417, 418, 419, 351, 420, 106, 107, 108, 421, 422, 423, 356, 424, 329, 425, 116, 359, 426, 427, 362, 428, 122, 123, 124, 429, 430, 431, 432, 367, 433, 434, 303, 133, 304, 305, 306, 226, 435, 436, 437, 438, 439, 440, 441, 442, 443, 444, 445, 446, 447, 448, 449, 450, 451, 452, 453, 454, 455, 456, 457, 458, 459, 460, 100, 251, 252, 253, 166, 254, 255, 256, 108, 257, 258, 259, 173, 461, 462, 463, 263, 464, 465, 466, 467, 468, 469, 470, 471, 472, 473, 474, 475, 476, 477, 478,
345, 346, 347, 100, 479, 480, 481, 351, 352, 482, 483, 108, 484, 485, 486, 356, 487, 398, 488, 116, 359, 489, 490, 362, 363, 214, 215, 124, 491, 492, 493, 494, 495, 496, 497, 498, 133, 499, 500, 501, 502, 503, 504, 505, 506, 507, 508, 509, 510, 511, 147, 512, 513, 514, 515, 516, 153, 517, 518, 519, 520, 521, 522, 523, 524, 525, 526, 100, 251, 252, 253, 166, 254, 255, 256, 108, 257, 258, 259, 173, 527, 528, 529, 530, 531, 532, 533, 534, 535, 536, 537, 538, 539, 540, 541, 542, 543, 544, 545,
415, 416, 281, 100, 546, 547, 419, 351, 548, 549, 550, 108, 551, 552, 553, 356, 554, 462, 555, 116, 556, 557, 558, 362, 428, 122, 123, 124, 559, 560, 561, 562, 563, 564, 565, 132, 133, 566, 567, 568, 569, 570, 571, 572, 573, 574, 575, 576, 577, 578, 147, 579, 580, 581, 582, 583, 153, 154, 584, 585, 586, 587, 588, 589, 590, 591, 592, 100, 251, 252, 253, 166, 254, 255, 256, 108, 257, 258, 259, 173, 593, 594, 595, 596, 597, 598, 599, 600, 601, 602, 603, 184, 604, 605, 606, 607, 608, 609, 545,
610, 611, 612, 613, 614, 615, 616, 617, 618, 619, 620, 621, 622, 623, 624, 625, 626, 627, 628, 629, 630, 631, 632, 633, 634, 635, 636, 637, 638, 639, 640, 641, 642, 643, 644, 645, 646, 647, 648, 649, 650, 651, 652, 653, 654, 655, 656, 657, 658, 659, 236, 660, 661, 662, 663, 664, 665, 666, 667, 668, 669, 670, 671, 672, 673, 674, 675, 613, 676, 677, 678, 679, 680, 681, 682, 621, 683, 684, 685, 686, 687, 688, 689, 690, 691, 692, 693, 694, 695, 696, 697, 698, 699, 639, 700, 701, 702, 703, 704,
705, 706, 707, 708, 709, 710, 711, 712, 713, 714, 715, 716, 717, 718, 719, 720, 721, 722, 723, 724, 725, 726, 727, 728, 729, 730, 731, 732, 733, 734, 735, 736, 737, 738, 739, 740, 741, 742, 743, 744, 745, 746, 747, 748, 749, 750, 751, 752, 753, 754, 313, 755, 756, 757, 758, 759, 760, 761, 762, 763, 764, 765, 766, 767, 768, 769, 707, 708, 770, 771, 772, 773, 774, 775, 776, 716, 777, 778, 779, 780, 781, 782, 783, 784, 785, 786, 787, 788, 789, 790, 791, 792, 793, 734, 794, 795, 796, 797, 798,
799, 800, 801, 802, 803, 804, 805, 806, 807, 808, 809, 810, 811, 812, 813, 814, 815, 816, 817, 818, 819, 820, 821, 822, 823, 824, 825, 826, 827, 828, 829, 830, 831, 832, 833, 834, 835, 836, 837, 838, 839, 840, 841, 842, 843, 844, 845, 846, 847, 848, 849, 850, 851, 852, 853, 854, 855, 856, 857, 858, 859, 860, 861, 862, 863, 800, 801, 802, 803, 804, 864, 865, 866, 808, 809, 810, 811, 812, 867, 868, 869, 816, 870, 871, 872, 820, 821, 822, 823, 824, 873, 874, 875, 828, 876, 877, 878, 879, 880