50 3815 369 -1 3075 4090 3597 0 10 16 1

0 0 80 2 400 0
0 0 402 5632 2 1
0 2777 210 535 2 1
0 3321 214 4 22 0

11 3135 360 32 6 1 -1 338
0 3145 399 40 5 2 3 -1 16 16
0 3170 405 32 32 2 1 -1 16 16
7 3204 431 29 22 2 stage3 -1 -1 0.00 -0.00 7 0 0

0 3338 276 100 2 1
0 3420 279 3 22 0
0 3585 241 4 160 0
0 3586 243 125 3 1

11 3390 230 32 6 1 -1 212
0 3403 268 32 5 2 3 -1 16 16
0 3422 278 32 32 2 1 -1 16 16
0 3454 301 32 32 2 1 -1 16 16
0 3486 333 32 32 2 1 -1 16 16
0 3518 365 32 24 2 1 -1 16 16
0 3535 395 32 5 2 0 -1 16 16
11 3535 390 32 5 -1 -1 336

11 3765 360 32 6 1 -1 338
0 3786 399 40 5 2 3 -1 16 16
0 3808 405 32 32 2 1 -1 16 16
7 3845 431 29 22 2 stage3.1 -1 -1 0.00 -0.00 7 0 0

0 3706 242 5 190 0
0 3716 242 55 6 1
0 3781 275 86 6 1
0 3768 245 6 23 0
0 4077 238 20 162 0
0 4034 83 5 25 0
0 3905 211 425 6 1
0 3056 239 32 166 0