666 4170 120 1 stage2.3
50 4750 120 1 4080 5630 4080 0 0

0 0 402 5632 2 1
0 4077 238 20 162 0

0 3905 211 420 6 1
11 4280 160 32 6 1 -1 147
0 4305 210 40 5 2 3 -1 16 16 4295
0 4320 212 32 32 2 1 -1 16 16
0 4332 215 32 32 2 1 -1 16 16
0 4352 244 32 16 2 1 -1 16 16
0 4380 260 38 16 2 0 -1 16 16 4355
11 4367 260 38 16 -1 -1 210
0 4354 275 356 6 1

11 4680 209 32 6 1 -1 210
0 4676 272 32 8 2 3 -1 16 16 4675
0 4704 278 32 32 2 1 -1 16 16
0 4737 305 32 32 2 1 -1 16 16
0 4769 337 32 32 2 1 -1 16 16
0 4801 369 32 16 2 1 -1 16 16
0 4815 388 32 16 2 0 -1 16 16 4800
11 4815 388 32 16 -1 -1 336

0 5441 340 31 6 1
11 5452 333 32 16 -1 -1 275
0 5452 333 32 16 2 0 1 16 16 5442
0 5506 277 32 32 2 1 1 16 16
0 5474 309 32 32 2 1 1 16 16
0 5525 269 32 16 2 3 1 16 16 5505
0 5538 273 96 6 1
11 5544 230 32 6 1 -1 208

8 4500 335 -1 0 80 500 5000 1
8 4560 335 -1 0 80 500 5000 1
8 5100 335 -1 0 80 500 5000 1
