50 1200 338 1 0 3085 0 0 0

0 0 80 2 400 0
0 0 402 5632 2 1

11 1232 395 32 5 -1 -1 336
0 1232 395 32 5 2 0 1 15 15
0 1232 367 32 32 2 1 1 15 15
0 1264 335 32 32 2 1 1 16 16
0 1296 303 32 32 2 1 1 16 16
0 1328 285 32 32 2 1 1 16 16
0 1350 280 32 32 2 1 1 16 16
0 1358 268 32 5 2 3 1 16 16
11 1384 224 32 6 1 -1 213 
0 1362 277 105 2 1
8 1362 244 -1 1 10 1000 5000 0 100 100
0 1352 244 32 32 4

11 1425 270 32 6 -1 -1 210
0 1425 270 32 10 2 0 1 16 16
0 1428 241 32 24 2 1 1 16 16
0 1460 215 32 32 2 1 1 16 16
0 1488 200 32 8 2 3 1 16 16
0 1492 195 32 8 2 2 1 16 16
0 1492 213 340 2 1
11 1500 148 32 6 1 1 149

11 1785 148 32 6 1 -1 149
0 1802 200 32 8 2 3 -1 16 16
0 1809 215 32 16 2 1 -1 16 16
0 1841 224 32 32 2 1 -1 16 16
0 1868 250 32 20 2 1 -1 16 16
0 1870 270 32 5 2 0 -1 16 16
11 1870 270 32 6 -1 -1 210
0 1848 275 200 2 1



10 3057 110 -1 3075 3842 235
11 2575 399 32 6 -1 -1 336
0 2575 400 32 5 2 0 1 16 16
0 2575 370 32 25 2 1 1 16 16
0 2607 338 32 32 2 1 1 16 16
0 2639 306 32 32 2 1 1 16 16
0 2671 274 32 32 2 1 1 16 16
0 2703 242 32 32 2 1 1 16 16
0 2740 220 32 32 2 1 1 16 16
0 2772 215 32 16 2 1 1 16 16
0 2770 203 32 5 2 3 1 16 16
11 2790 150 32 6 1 -1 147
0 2777 210 535 2 1

2 56 323 1 101 1
2 188 280 1 101 1

8 352 335 -1 0 80 300 5000 1
8 425 335 -1 0 80 400 5000 1
8 485 335 -1 0 80 500 5000 1
8 732 335 -1 0 80 500 5000 1
8 2400 335 -1 0 80 500 5000 1
8 2460 335 -1 0 80 500 5000 1
8 2566 335 -1 0 80 500 5000 1


0 3056 239 32 166 0

7 3204 431 29 22 2 stage3 -1 -1 0.00 -0.00 7 0 0
0 2777 210 535 2 1
0 3321 214 4 22 0

11 3135 360 32 6 1 -1 338
0 3145 399 40 5 2 3 -1 16 16
0 3170 405 32 32 2 1 -1 16 16

0 3338 276 100 2 1
0 3420 279 3 22 0
11 3390 230 32 6 1 -1 212
0 3403 268 32 5 2 3 -1 16 16
0 3422 278 32 32 2 1 -1 16 16
0 3454 301 32 32 2 1 -1 16 16
0 3486 333 32 32 2 1 -1 16 16
0 3518 365 32 24 2 1 -1 16 16
0 3535 395 32 5 2 0 -1 16 16
11 3535 390 32 5 -1 -1 336

0 3585 241 4 160 0
0 3586 243 125 3 1