50 2700 100 0 3085 2600 0
0 0 80 2 400 0
0 0 402 5632 2 1
0 1232 395 32 5 2 0 1 15 15
0 1232 367 32 32 2 1 1 15 15
0 1264 335 32 32 2 1 1 16 16
0 1296 303 32 32 2 1 1 16 16
0 1328 285 32 32 2 1 1 16 16
0 1350 280 32 32 2 1 1 16 16
0 1360 268 32 5 2 3 1 16 16
11 1384 224 32 6 1 -1 145
11 1510 136 32 6 1 -1 145
0 1358 277 105 2 1
2 56 323 1 101 1
2 188 280 1 101 1
8 352 335 -1 0 80 300 5000
8 425 335 -1 0 80 400 5000
8 485 335 -1 0 80 500 5000
0 1425 270 32 10 2 0 1 16 16
0 1428 241 32 24 2 1 1 16 16
0 1460 215 32 32 2 1 1 16 16
0 1488 200 32 8 2 3 1 16 16
0 1492 195 32 8 2 2 1 16 16
0 1492 213 330 2 1
0 1800 195 32 8 2 2 -1 16 16
0 1804 205 32 8 2 3 -1 16 16
0 1809 215 32 16 2 1 -1 16 16
0 1841 224 32 32 2 1 -1 16 16
0 1868 250 32 20 2 1 -1 16 16
0 1870 270 32 5 2 0 -1 16 16
0 1848 275 200 2 1
0 3056 236 8 185 0
10 3057 110 -1 3075 3842 235
11 2575 400 32 6 -1 -1 336
0 2575 398 32 5 2 0 1 16 16
0 2575 395 32 5 2 0 1 16 16
0 2575 370 32 25 2 1 1 16 16
0 2607 338 32 32 2 1 1 16 16
0 2639 306 32 32 2 1 1 16 16
0 2671 274 32 32 2 1 1 16 16
0 2703 242 32 32 2 1 1 16 16
0 2740 220 32 32 2 1 1 16 16
0 2772 215 32 16 2 1 1 16 16
0 2770 203 32 5 2 3 1 16 16
11 2790 150 32 6 1 -1 147
0 2777 210 560 2 1