1, 2, 3, 4, 5, 6, 1, 7, 1, 2, 3, 4, 5, 6, 1, 7, 1, 2, 3, 8, 9, 10, 1, 7, 1, 2, 3, 4, 5, 6, 1, 11, 12, 13, 3, 4, 5, 14,
15, 16, 17, 18, 19, 20, 21, 22, 23, 24, 17, 18, 19, 20, 21, 22, 23, 24, 17, 25, 26, 27, 21, 22, 23, 24, 17, 18, 19, 20, 21, 28, 29, 30, 17, 18, 19, 31,
32, 33, 17, 34, 35, 36, 37, 38, 39, 40, 17, 34, 35, 36, 37, 38, 39, 40, 17, 41, 42, 43, 37, 38, 39, 40, 17, 34, 35, 36, 37, 44, 32, 33, 17, 34, 35, 45,
46, 24, 17, 47, 48, 49, 50, 51, 23, 24, 17, 52, 53, 54, 50, 51, 23, 24, 17, 18, 19, 55, 50, 51, 23, 24, 17, 52, 53, 54, 50, 56, 46, 24, 17, 52, 53, 57,
39, 40, 17, 58, 59, 60, 61, 62, 39, 40, 17, 34, 35, 63, 61, 62, 39, 40, 17, 34, 35, 63, 61, 62, 39, 40, 17, 34, 35, 63, 61, 62, 39, 40, 17, 34, 35, 45,
23, 24, 17, 64, 65, 66, 61, 67, 23, 24, 17, 47, 48, 68, 61, 69,21, 70, 17, 52, 53, 71, 61, 67, 23, 24, 17, 47, 48, 68, 61, 67, 23, 24, 17, 52, 53, 57,
39, 40, 17, 72, 39, 71, 61, 62, 39, 40, 17, 58, 59, 60, 61, 73, 37, 74, 17, 34, 35, 63, 61, 62, 39, 40, 17, 58, 59, 60, 61, 62, 39, 40, 17, 34, 35, 45,
23, 24, 17, 75, 23, 66, 61, 69, 21, 70, 17, 64, 65, 66, 61, 76, 29, 30, 17, 47, 48, 68, 61, 67, 23, 24, 17, 64, 65, 66, 61, 77, 15, 16, 17, 47, 48, 78,
39, 40, 17, 72, 39, 71, 61, 73, 37, 74, 17, 72, 39, 71, 61, 79, 32, 33, 17, 58, 59, 60, 61, 62, 39, 40, 17, 72, 39, 71, 61, 79, 32, 33, 17, 58, 59, 80,
81, 82, 83, 84, 81, 85, 86, 87, 88, 89, 83, 84, 81, 85, 86, 90, 91, 82, 83, 92, 93, 85, 86, 94, 81, 82, 83, 84, 81, 85, 86, 90, 91, 82, 83, 92, 93, 95,
96, 97, 98, 99, 96, 100, 96, 100, 96, 97, 98, 99, 96, 100, 96, 100, 96, 97, 98, 99, 96, 100, 96, 100, 96, 97, 98, 99, 96, 100, 96, 100, 96, 97, 98, 99, 96, 101,
102, 102, 102, 102, 102, 102, 102, 102, 102, 102, 102, 102, 102, 102, 102, 102, 102, 102, 102, 102, 102, 102, 102, 102, 102, 102, 102, 102, 102, 102, 102, 102, 102, 102, 102, 102, 102, 103,
104, 104, 104, 104, 104, 104, 104, 104, 104, 104, 104, 104, 104, 104, 104, 104, 104, 104, 104, 104, 104, 104, 104, 104, 104, 104, 104, 104, 104, 104, 104, 104, 104, 104, 104, 104, 104, 104,
104, 104, 104, 104, 104, 104, 104, 104, 104, 104, 104, 104, 104, 104, 104, 104, 104, 104, 104, 104, 104, 104, 104, 104, 104, 104, 104, 104, 104, 104, 104, 104, 104, 104, 104, 104, 104, 104,
104, 104, 104, 104, 104, 104, 104, 104, 104, 104, 104, 104, 104, 104, 104, 104, 104, 104, 104, 104, 104, 104, 104, 104, 104, 104, 104, 104, 104, 104, 104, 104, 104, 104, 104, 104, 104, 104,
104, 104, 104, 104, 104, 104, 104, 104, 104, 104, 104, 104, 104, 104, 104, 104, 104, 104, 104, 104, 104, 104, 104, 104, 104, 104, 104, 104, 104, 104, 104, 104, 104, 104, 104, 104, 104, 104,
104, 104, 104, 104, 104, 104, 104, 104, 104, 104, 104, 104, 104, 104, 104, 104, 104, 104, 104, 104, 104, 104, 104, 104, 104, 104, 104, 104, 104, 104, 104, 104, 104, 104, 104, 104, 104, 104,
104, 104, 104, 104, 104, 104, 104, 104, 104, 104, 104, 104, 104, 104, 104, 104, 104, 104, 104, 104, 104, 104, 104, 104, 104, 104, 104, 104, 104, 104, 104, 104, 104, 104, 104, 104, 104, 104,
104, 104, 104, 104, 104, 104, 104, 104, 104, 104, 104, 104, 104, 104, 104, 104, 104, 104, 104, 104, 104, 104, 104, 104, 104, 104, 104, 104, 104, 104, 104, 104, 104, 104, 104, 104, 104, 104,
104, 104, 104, 104, 104, 104, 104, 104, 104, 104, 104, 104, 104, 104, 104, 104, 104, 104, 104, 104, 104, 104, 104, 104, 104, 104, 104, 104, 104, 104, 104, 104, 104, 104, 104, 104, 104, 104,
104, 104, 104, 104, 104, 104, 104, 104, 104, 104, 104, 104, 104, 104, 104, 104, 104, 104, 104, 104, 104, 104, 104, 104, 104, 104, 104, 104, 104, 104, 104, 104, 104, 104, 104, 104, 104, 104
104, 104, 104, 104, 104, 104, 104, 104, 104, 104, 104, 104, 104, 104, 104, 104, 104, 104, 104, 104, 104, 104, 104, 104, 104, 104, 104, 104, 104, 104, 104, 104, 104, 104, 104, 104, 104, 104,
104, 104, 104, 104, 104, 104, 104, 104, 104, 104, 104, 104, 104, 104, 104, 104, 104, 104, 104, 104, 104, 104, 104, 104, 104, 104, 104, 104, 104, 104, 104, 104, 104, 104, 104, 104, 104, 104