50 3175 369 -1 3075 3842 3075 0 10 16 1

0 0 80 2 400 0
0 0 402 5632 2 1
0 2777 210 535 2 1
0 3321 214 4 22 0

11 3135 360 32 6 1 -1 338
0 3145 399 40 5 2 3 -1 16 16
0 3170 405 32 32 2 1 -1 16 16

0 3338 276 100 2 1
0 3420 279 3 22 0
11 3390 230 32 6 1 -1 212
0 3406 268 32 32 2 3 -1 11 11
0 3422 278 32 32 2 1 -1 15 15
0 3454 301 32 32 2 1 -1 15 15
0 3486 333 32 32 2 1 -1 15 15
0 3518 365 32 24 2 1 -1 15 15
0 3535 395 32 5 2 0 -1 16 16
11 3535 390 32 5 -1 -1 336

7 3204 431 29 22 2 stage3 -1 -1 0.00 -0.00 7
0 3585 241 4 160 0
0 3586 243 125 3 1
0 3056 239 32 166 0

8 3545 70 -1 2 50 500 4000 1