666 0 335 1 stage2
50 0 335 1 1 3085 0 0 0

0 0 80 2 400 0
0 0 402 5632 2 1

11 1232 395 32 5 -1 -1 336 
0 1232 395 32 5 2 0 1 16 16 1216
0 1232 367 32 32 2 1 1 16 16
0 1264 335 32 32 2 1 1 16 16
0 1296 303 32 32 2 1 1 16 16
0 1328 285 32 32 2 1 1 16 16
0 1350 280 32 32 2 1 1 16 16
0 1360 268 32 5 2 3 1 5 12 1344
11 1384 224 32 6 1 -1 213 
0 1362 277 105 2 1

8 1362 243 -1 1 1 1000 5000 0 100 100
8 1757 181 -1 1 1 1000 5000 0 100 100
8 1757 181 -1 1 1 1000 5000 0 100 100
8 1886 243 -1 1 1 1000 5000 0 100 100

8 352 337 -1 0 120 300 8000 1
8 425 337 -1 0 120 400 8000 1
8 485 337 -1 0 120 500 8000 1
8 732 337 -1 0 120 500 8000 1
8 2400 337 -1 0 120 500 8000 1
8 2460 337 -1 0 120 500 8000 1
8 2566 337 -1 0 120 500 8000 1

0 1343 253 10 23 4
0 1479 244 10 32 4
0 1487 193 6 32 4
0 1836 192 7 32 4
0 1850 257 5 20 4
0 2020 253 10 24 4

11 1425 270 32 6 -1 -1 210
0 1425 270 32 10 2 0 1 16 16 1406
0 1428 241 32 24 2 1 1 16 16
0 1460 215 32 32 2 1 1 16 16
0 1488 200 32 8 2 3 1 16 16 1472
0 1492 195 32 8 2 2 1 16 16
0 1492 213 340 2 1
11 1500 148 32 6 1 1 149

11 1785 148 32 6 1 -1 149
0 1810 200 32 8 2 3 -1 24 24 1800
0 1809 215 32 16 2 1 -1 16 16
0 1841 224 32 32 2 1 -1 16 16
0 1868 250 32 20 2 1 -1 16 16
0 1870 270 32 5 2 0 -1 16 16 1860
11 1870 270 32 6 -1 -1 210 
0 1848 275 161 2 1
1 2017 275 32 32 106

10 3057 110 -1 3075 3842 235 3140 120 1 stage2.1

11 2575 399 32 6 -1 -1 336
0 2575 400 32 5 2 0 1 16 16 2560
0 2575 370 32 25 2 1 1 16 16
0 2607 338 32 32 2 1 1 16 16
0 2639 306 32 32 2 1 1 16 16
0 2671 274 32 32 2 1 1 16 16
0 2703 242 32 32 2 1 1 16 16
0 2740 220 32 32 2 1 1 16 16
0 2772 215 32 16 2 1 1 16 16
0 2770 203 32 5 2 3 1 11 11 2754
11 2790 150 32 6 1 -1 147
0 2777 210 535 2 1



2 186 275 1 101 1
2 438 275 1 101 1
2 696 275 1 101 1
2 950 275 1 101 1
2 1205 275 1 101 1
2 2740  275 1 101 1

2 55 336 1 106 1
2 312 336 1 101 1
2 565 336 1 101 1
2 822 336 1 101 1
2 1080 336 1 101 1
2 1460 336 1 105 1
2 1847 336 1 105 1
2 2100 336 1 101 1
2 2230 336 1 101 1
2 2360 336 1 101 1
2 2486 336 1 101 1
2 2613 336 1 101 1

2 1335 151 1 101 1
2 1720 151 1 101 1
2 1977 151 1 101 1
2 2872 151 1 101 1

2 1590 85 1 3 1
2 2999 85 1 108 1



0 2777 210 550 2 1
0 3321 214 4 22 0

11 3135 360 32 6 1 -1 338
0 3145 399 40 5 2 3 -1 16 16 3138
0 3170 405 32 32 2 1 -1 16 16
7 3204 431 29 22 2 stage3 -1 -1 0.00 -0.00 7

0 3328 275 104 5 1
11 3390 230 32 6 1 -1 212
0 3415 268 32 16 2 3 -1 16 16 3398
0 3399 268 32 16 2 1 -1 25 25
0 3422 278 32 32 2 1 -1 15 15
0 3454 301 32 32 2 1 -1 15 15
0 3486 333 32 32 2 1 -1 15 15
0 3518 365 32 24 2 1 -1 15 15
0 3535 395 32 5 2 0 -1 16 16 3520
11 3535 390 32 5 -1 -1 336

0 3056 239 32 166 0

0 3585 241 4 96 0
0 3586 243 125 3 1
1 3586 339 32 35 -1
1 3586 370 32 35 107
0 3589 331 128 10 6
0 3620 331 3 125 0

8 3500 70 -1 2 50 500 4000 1

2 3125 336 1 105 1
2 3767 336 1 101 1

2 3514 275 1 101 1

2 3256 151 1 100 1
2 4025 151 1 101 1

2 3385 120 1 101 1
2 3670 120 1 100 1
2 3890 90 1 108 1