666 3140 0 1 stage2.1
50 736 48 1 0 1024 535 0 10 16 -1

0 0 80 10 400 0
0 0 244 440 10 1
7 92 36 24 15 1 stage2.1 -1 -1 0.00 -0.00 7
0 98 80 32 32 2 1 -1 16 16
0 130 112 32 32 2 1 -1 16 16
0 162 144 32 32 2 1 -1 16 16
0 175 178 48 5 2 0 -1 16 16
11 177 176 32 5 -1 -1 116
0 195 181 62 5 1

0 510 243 65 2 1
0 968 307 52 2 1
0 901 371 56 2 1
0 1010 80 10 229 0
7 730 36 24 15 1 stage2.2 -1 -1 0.00 -0.00 7
0 736 80 32 32 2 1 -1 16 16
0 768 112 32 32 2 1 -1 16 16
0 800 144 32 32 2 1 -1 16 16
0 832 176 32 32 2 1 -1 16 16
0 864 208 32 24 2 1 -1 16 16
0 883 238 32 5 2 0 -1 16 16
11 883 237 32 5 -1 -1 177
0 650 244 300 2 1
8 100 400 -1 3 -1 600 2000 3 280 20
8 350 400 -1 3 -1 600 2000 3 280 70
14 0 380 900 5
14 980 397 30 75


2 53 123 1 105 1
2 183 123 1 101 1
2 310 123 1 101 1
2 437 123 1 105 1
2 555 123 1 4 1
2 695 123 1 104 1
2 825 123 1 101 1
2 980 123 1 101 1