666 3140 140 1 stage2.1
50 3815 369 -1 3075 4090 3597 0 10 16 1

11 3765 360 32 6 1 -1 338
0 3786 399 40 5 2 3 -1 16 16 3774
0 3808 405 32 32 2 1 -1 16 16
7 3845 431 29 22 2 stage3.1 -1 -1 0.00 0.00 7

0 3706 245 5 190 0
0 3578 242 197 6 1
0 3768 245 6 23 0
0 4077 238 20 162 0
0 4034 83 5 25 0
0 3905 211 425 6 1

0 3781 275 90 6 1
11 3840 238 32 5 1 -1 211

0 3843 271 32 16 2 3 -1 16 16 3843
0 3876 290 44 38 2 1 -1 16 16
0 3903 307 32 32 2 1 -1 16 16
0 3935 339 32 32 2 1 -1 16 16
0 3967 371 32 16 2 1 -1 16 16

0 3984 395 32 5 2 0 -1 16 16 3968
11 3984 390 32 5 -1 -1 336

10 4068 110 -1 4080 5630 235 3140 120 1 stage2.3




12 5308 111

0 0 402 5632 2 1
0 4077 238 20 162 0

0 3905 211 420 6 1
11 4280 160 32 6 1 -1 147
0 4305 210 40 5 2 3 -1 16 16 4295
0 4320 212 32 32 2 1 -1 16 16
0 4332 215 32 32 2 1 -1 16 16
0 4352 244 32 16 2 1 -1 16 16
0 4380 260 38 16 2 0 -1 16 16 4355
11 4367 260 38 16 -1 -1 210
0 4354 275 356 6 1

11 4680 209 32 6 1 -1 210
0 4676 272 32 8 2 3 -1 16 16 4675
0 4704 278 32 32 2 1 -1 16 16
0 4737 305 32 32 2 1 -1 16 16
0 4769 337 32 32 2 1 -1 16 16
0 4801 369 32 16 2 1 -1 16 16
0 4815 388 32 16 2 0 -1 16 16 4800
11 4815 388 32 16 -1 -1 336


0 5442 343 2 24 0
0 5469 343 2 24 0
0 5441 340 31 6 1
1 5475 340 32 32 109
11 5452 333 32 16 -1 -1 275
0 5452 333 32 16 2 0 1 16 16 5442
0 5506 277 32 32 2 1 1 16 16
0 5474 309 32 32 2 1 1 16 16
0 5525 269 32 16 2 3 1 16 16 5505
0 5538 273 96 6 1
11 5544 230 32 6 1 -1 208

0 5615 75 20 330 0
10 5616 177 -1 4080 5630 240 3140 120 1 stage4

8 4500 335 -1 0 80 500 5000 1
8 4560 335 -1 0 80 500 5000 1
8 5100 335 -1 0 80 500 5000 1

2 4279 151 1 101 1
2 4537 151 1 110 1

2 4154 275 1 100 1
2 4790 275 1 1 1
2 5174 275 1 100 1
2 5429 275 1 101 1
2 5555 275 1 100 1

2 4664 336 1 101 1
2 4916 336 1 101 1
2 5050 336 1 101 1
2 5307 336 1 101 1
0 5445 345 2 20 0


0 0 402 5632 2 1
0 2777 210 550 2 1
0 3321 214 4 22 0

11 3135 360 32 6 1 -1 338
0 3145 399 40 5 2 3 -1 16 16 3138
0 3170 405 32 32 2 1 -1 16 16
7 3204 431 29 22 2 stage3 -1 -1 0.00 -0.00 7

0 3328 275 104 5 1
11 3390 230 32 6 1 -1 212
0 3415 268 32 16 2 3 -1 16 16 3398
0 3399 268 32 16 2 1 -1 25 25
0 3422 278 32 32 2 1 -1 15 15
0 3454 301 32 32 2 1 -1 15 15
0 3486 333 32 32 2 1 -1 15 15
0 3518 365 32 24 2 1 -1 15 15
0 3535 395 32 5 2 0 -1 16 16 3520
11 3535 390 32 5 -1 -1 336

0 3056 239 32 166 0

0 3585 241 4 96 0
0 3586 243 125 3 1
1 3586 339 32 35 -1
1 3586 370 32 35 107
0 3589 331 128 10 6
0 3620 331 3 125 0

8 3500 70 -1 2 50 500 4000 1

2 3125 336 1 105 1
2 3767 336 1 101 1

2 3514 275 1 101 1

2 3256 151 1 100 1
2 4025 151 1 101 1

2 3385 120 1 101 1
2 3670 120 1 100 1
2 3890 90 1 108 1