1, 2, 3, 4, 5, 6, 7, 8, 9, 10, 11, 4, 5, 6, 7, 8, 9, 10, 11, 12, 13, 14, 15, 8, 9, 10, 11, 4, 5, 6, 7, 16, 17, 18, 19, 4, 5, 20, 21, 22, 23, 24, 9, 24, 9, 24, 9, 10, 11, 4, 25, 26, 27, 28, 29, 30, 31, 32, 33, 24, 9, 34, 17, 18, 19, 35, 36, 37, 38, 35, 36, 37, 38, 35, 36, 37, 38, 39, 40, 41, 42, 22, 23, 43, 44, 45, 46, 32, 33, 47, 48, 28, 29, 49, 50, 51,
53, 54, 55, 56, 57, 58, 59, 60, 61, 62, 63, 56, 57, 58, 59, 60, 61, 62, 63, 64, 65, 66, 67, 60, 61, 62, 63, 56, 57, 58, 59, 68, 69, 70, 55, 56, 57, 71, 72, 73, 74, 75, 76, 75, 76, 75, 76, 62, 63, 77, 78, 79, 80, 81, 82, 83, 84, 85, 76, 75, 76, 86, 87, 70, 55, 88, 89, 90, 91, 88, 89, 90, 91, 88, 89, 90, 91, 92, 93, 94, 95, 73, 74, 96, 97, 98, 97, 85, 76, 99, 100, 81, 82, 101, 102, 103,
105, 106, 107, 56, 108, 109, 110, 111, 112, 113, 114, 56, 115, 116, 117, 111, 112, 113, 114, 118, 119, 120, 121, 111, 112, 113, 114, 56, 115, 116, 117, 122, 123, 106, 107, 56, 115, 124, 125, 126, 127, 128, 129, 130, 131, 132, 133, 134, 135, 136, 137, 138, 139, 140, 141, 142, 143, 144, 145, 146, 147, 148, 149, 106, 107, 150, 151, 81, 82, 150, 151, 81, 82, 150, 151, 81, 82, 152, 153, 154, 155, 126, 127, 130, 131, 132, 133, 156, 157, 158, 159, 160, 161, 162, 163, 164,
166, 167, 63, 77, 168, 169, 170, 73, 74, 62, 63, 56, 171, 172, 173, 73, 74, 62, 63, 56, 57, 71, 72, 73, 74, 62, 63, 56, 171, 172, 173, 174, 175, 167, 63, 56, 171, 176, 177, 178, 179, 75, 76, 180, 181, 182, 183, 184, 185, 186, 187, 188, 189, 190, 191, 192, 193, 194, 195, 196, 197, 96, 97, 167, 63, 150, 151, 81, 82, 150, 151, 81, 82, 150, 151, 81, 82, 198, 199, 200, 201, 178, 179, 180, 181, 182, 183, 202, 203, 204, 205, 206, 207, 208, 209, 210,
212, 113, 114, 213, 214, 215, 216, 126, 127, 113, 114, 56, 108, 217, 218, 126, 219, 220, 114, 56, 115, 124, 125, 126, 127, 113, 114, 56, 108, 217, 218, 126, 127, 113, 114, 56, 115, 124, 125, 221, 222, 132, 133, 223, 224, 225, 226, 227, 228, 229, 230, 231, 232, 233, 234, 235, 236, 237, 238, 239, 240, 241, 157, 242, 243, 150, 151, 81, 82, 150, 151, 81, 82, 150, 151, 81, 82, 244, 245, 246, 247, 221, 222, 248, 249, 225, 226, 250, 251, 252, 253, 254, 255, 256, 257, 258,
260, 62, 63, 261, 262, 263, 100, 178, 179, 62, 63, 77, 168, 264, 265, 266, 267, 268, 269, 56, 171, 176, 177, 178, 179, 62, 63, 77, 168, 264, 265, 178, 179, 62, 63, 56, 171, 176, 177, 270, 271, 182, 183, 272, 273, 274, 275, 276, 277, 278, 279, 280, 281, 282, 283, 284, 285, 286, 287, 288, 289, 290, 291, 292, 91, 150, 151, 81, 82, 150, 151, 81, 82, 150, 151, 81, 82, 293, 294, 295, 296, 270, 271, 297, 298, 299, 300, 301, 302, 303, 304, 305, 306, 307, 308, 309,
212, 113, 114, 152, 311, 312, 155, 126, 219, 220, 114, 213, 214, 215, 216, 313, 314, 315, 316, 56, 108, 217, 218, 126, 127, 113, 114, 213, 214, 215, 216, 317, 318, 319, 320, 56, 108, 321, 322, 323, 324, 225, 226, 325, 326, 327, 328, 329, 63, 152, 311, 148, 149, 106, 107, 330, 331, 332, 333, 334, 335, 336, 337, 338, 339, 150, 151, 81, 82, 150, 151, 81, 82, 150, 151, 81, 82, 340, 341, 342, 343, 323, 324, 225, 344, 345, 346, 347, 348, 128, 129, 113, 114, 349, 350, 351,
260, 62, 63, 92, 93, 99, 100, 266, 267, 268, 269, 261, 262, 263, 100, 353, 354, 70, 55, 77, 168, 264, 265, 178, 179, 62, 63, 261, 262, 263, 100, 353, 355, 54, 55, 77, 168, 356, 357, 358, 359, 299, 300, 360, 361, 362, 363, 364, 365, 92, 93, 96, 97, 167, 63, 83, 366, 367, 368, 369, 370, 371, 372, 373, 374, 150, 151, 81, 82, 150, 151, 81, 82, 150, 151, 81, 82, 375, 376, 377, 378, 358, 359, 299, 379, 380, 381, 382, 383, 75, 76, 62, 63, 384, 385, 351,
386, 387, 135, 388, 389, 390, 391, 392, 393, 394, 395, 388, 389, 390, 391, 396, 397, 398, 399, 136, 137, 138, 400, 401, 402, 387, 135, 388, 389, 390, 391, 396, 397, 398, 399, 136, 137, 403, 404, 225, 405, 406, 407, 408, 409, 410, 411, 387, 135, 388, 389, 241, 412, 387, 135, 388, 389, 387, 135, 413, 414, 415, 416, 394, 395, 417, 418, 160, 161, 417, 418, 160, 161, 417, 418, 160, 161, 413, 414, 419, 420, 225, 405, 406, 407, 408, 409, 410, 411, 241, 412, 387, 135, 421, 422, 423,
424, 425, 426, 427, 428, 429, 430, 431, 432, 433, 426, 427, 428, 429, 430, 434, 435, 436, 426, 186, 187, 437, 430, 438, 439, 425, 426, 427, 428, 429, 430, 434, 435, 436, 426, 186, 187, 440, 441, 442, 443, 444, 445, 446, 447, 448, 449, 425, 426, 427, 428, 450, 449, 425, 426, 427, 428, 425, 426, 451, 452, 448, 453, 433, 426, 454, 455, 206, 207, 454, 455, 206, 207, 454, 455, 206, 207, 451, 452, 456, 441, 442, 443, 444, 445, 446, 447, 448, 449, 450, 449, 425, 426, 457, 458, 459,
461, 462, 463, 464, 465, 466, 467, 466, 467, 462, 463, 464, 465, 466, 467, 466, 467, 462, 463, 464, 465, 466, 467, 466, 467, 462, 463, 464, 465, 466, 467, 466, 467, 462, 463, 464, 465, 468, 469, 470, 471, 466, 467, 466, 467, 466, 467, 462, 463, 464, 465, 466, 467, 462, 463, 464, 465, 462, 463, 464, 465, 466, 467, 462, 463, 464, 465, 462, 463, 464, 465, 462, 463, 464, 465, 462, 463, 464, 465, 468, 469, 470, 471, 466, 467, 466, 467, 466, 467, 466, 467, 462, 463, 472, 473, 474