6 1850 100 0 0
0 0 80 2 400 0
0 0 402 5632 2 1
0 1232 395 32 5 2 0 1 15 15
0 1232 367 32 32 2 1 1 15 15
0 1264 335 32 32 2 1 1 16 16
0 1296 303 32 32 2 1 1 16 16
0 1328 281 32 32 2 1 1 16 16
0 1355 265 32 8 2 3 1 16 16
0 1360 280 16 16 2 1 1 16 16
0 1360 235 32 32 2 2 1 16 16
0 1360 277 100 2 1
2 56 323 1 101 1
2 188 280 1 101 1
8 352 335 -1 0 80 300 5000
8 425 335 -1 0 80 400 5000
8 485 335 -1 0 80 500 5000
0 1425 270 32 10 2 0 1 16 16
0 1428 241 32 24 2 1 1 16 16
0 1460 215 32 32 2 1 1 16 16
0 1488 200 32 8 2 3 1 16 16
0 1492 195 32 8 2 2 1 16 16
0 1492 213 320 2 1
0 1848 275 200 2 1
0 1800 195 32 8 2 2 -1 16 16
0 1804 205 32 8 2 3 -1 16 16
0 1809 215 32 16 2 1 -1 16 16
0 1841 224 32 32 2 1 -1 16 16
0 1868 268 32 10 2 0 -1 16 16